3 12 7305 7281 2798 7233 3721 7156 5290 3784 1341 2148 7162 7194 
3 3 5290 3718 7278 
4 9 2807 1341 1164 5846 7057 7023 7020 1395 3979 
4 14 2301 827 3880 6875 6893 6919 6942 3868 6948 5087 7008 6948 5087 1395 
1 2 7530 4106 
3 18 3868 6948 1768 1935 6900 6880 1555 6904 6871 1392 6861 6880 6841 769 6832 577 6858 5703 
3 17 6900 4831 5703 6858 577 6875 827 6832 198 2507 6825 6841 6880 5785 6807 2507 701 
1 2 1768 6904 
1 10 701 2403 6736 6690 966 6684 4441 6664 5426 6630 
1 5 6736 2950 4590 1915 1928 
2 4 3539 6753 1352 6713 
1 2 6713 5561 
1 5 6753 6767 4265 6830 1392 
1 5 6767 6790 275 5382 6861 
1 2 4590 2987 
1 2 6690 2159 
1 2 6664 3993 
3 5 6830 6840 5042 5844 2340 
1 3 6904 599 2340 
1 4 6904 6871 6870 6840 
1 2 5844 6870 
1 7 6807 2895 6790 606 491 5937 6753 
1 4 491 6765 6783 701 
1 10 3539 2962 6757 5606 3127 6759 3385 6806 4520 5298 
1 2 6824 4520 
1 3 4520 6806 3385 
2 2 5298 4988 
1 6 4988 5721 3549 4764 2639 5844 
1 3 4764 6874 1073 
3 5 4988 6903 915 6911 3723 
1 5 6911 6936 6918 4926 6935 
1 2 6961 6935 
1 5 2340 6937 4133 5780 7020 
1 3 599 6939 1395 
3 10 2807 5681 7050 1166 3948 6983 6962 6931 6926 915 
3 16 2807 7134 7150 7160 3508 7199 578 7208 7186 4395 3912 7230 7216 7185 3250 7165 
2 3 3250 3404 7246 
1 3 4395 5646 7230 
1 2 7208 7219 
3 2 7208 7236 
2 6 3508 3375 7117 364 1419 2807 
1 3 1419 7050 1166 
2 7 7117 265 7102 5125 7072 7062 7095 
1 5 7072 7053 7039 3248 3948 
1 6 7072 5840 7019 7006 1565 6961 
1 4 7006 1526 7016 3029 
1 3 6961 1526 7016 
1 4 1565 6965 4583 6931 
1 4 7050 7031 7042 7023 
1 2 3029 5015 
1 2 7095 635 
5 2 7281 7270 
1 3 7233 2853 7199 
1 2 1928 2339 
2 11 5015 2017 4644 2629 4740 5046 7164 837 7108 2816 7045 
1 2 2816 7059 
1 8 2816 2687 4992 7071 5414 3057 4750 7069 
1 2 3079 4771 
1 3 4771 6999 6969 
1 2 2687 7086 
1 4 2629 4167 4674 7144 
1 5 3250 7170 5443 7182 4167 
3 8 3250 2543 7232 5228 7215 5546 564 2629 
1 2 1097 5015 
1 2 5015 4379 
1 2 7016 5712 
2 7 837 7191 4351 5309 1861 2650 7383 
2 6 2650 1423 7277 7250 7239 7215 
3 5 7250 4863 1883 7178 5046 
1 3 1883 7214 4351 
3 13 7383 4339 5498 7376 5224 4795 4613 7295 7274 7296 5351 3142 3404 
1 4 7295 1229 5228 7215 
1 3 4613 4817 7239 
1 4 7376 7389 7418 7433 
1 3 7433 7456 4471 
1 2 7418 7395 
1 3 7277 7303 4613 
1 3 1423 7351 5224 
1 5 4795 5238 7347 7326 3142 
2 2 2141 3142 
1 3 2141 7340 5920 
1 5 5920 7301 2567 7258 7236 
5 3 7281 2377 2853 
5 2 7258 3077 
5 2 3077 7280 
1 2 3077 7270 
1 2 7246 2567 
2 2 7467 7461 
3 5 7461 7469 179 4666 4694 
1 3 7441 3625 5784 
3 4 7467 4626 2012 5961 
3 2 7485 7467 
1 4 7404 4748 5863 7485 
1 20 4626 4273 7517 7539 7559 5289 7597 184 7600 7645 4699 1396 4577 7698 3053 7718 1304 2231 7828 2294 
2 6 7404 1979 7423 5187 1250 898 
3 7 5961 2091 3523 7651 1355 272 2797 
1 2 7651 3301 
3 5 2420 7654 7617 3523 1296 
1 4 1355 5859 4958 1874 
1 3 1874 2111 5264 
1 2 7709 7680 
3 5 2420 5910 3729 7669 7686 
3 3 7686 2990 7745 
1 2 7686 7677 
1 5 1874 2111 7786 7776 7788 
1 4 2091 5173 4211 4666 
1 3 2091 1296 7570 
3 6 7745 380 7803 4534 7796 7775 
2 7 7788 7809 7837 5625 7872 5272 7952 
1 3 7837 5497 7800 
3 6 7803 7819 30 2370 7862 7872 
3 3 2370 4898 1224 
1 3 4534 3761 2781 
1 2 3761 7850 
1 2 2781 7835 
1 2 2781 5279 
3 6 4898 7889 4619 7909 2147 7876 
1 6 7952 2771 7961 7984 2705 2255 
1 2 7617 1296 
1 2 7862 7839 
1 2 7803 5163 
1 4 1224 4998 2771 7952 
3 5 2147 4989 7903 7880 3616 
1 2 4989 7876 
3 6 7909 1042 7981 2213 8034 2255 
3 3 7981 4731 1984 
3 5 1984 2980 2661 2113 346 
1 2 7903 2113 
2 6 346 4738 5468 5853 7828 2294 
1 2 5853 2294 
1 3 2980 482 2351 
3 6 346 3925 7973 4326 8040 43 
1 7 2255 8067 8081 1537 8110 8129 1713 
1 2 5248 8152 
1 2 8152 8166 
3 6 1984 8045 1845 8079 2589 8140 
1 2 2589 8141 
3 3 43 4127 8078 
3 3 8078 5441 8055 
1 3 7946 7957 7973 
1 2 43 8079 
1 2 4738 7946 
3 7 5441 8103 3202 8114 1345 4202 8197 
1 2 8197 8221 
1 2 7505 3215 
1 5 7957 5521 4086 5944 8055 
1 2 4326 5934 
3 2 8086 8102 
1 2 8086 1389 
1 6 8086 5854 8032 8012 5603 150 
1 3 769 6858 6893 
1 4 984 3526 8219 1430 
1 4 5963 8224 8199 1004 
1 4 8224 8244 3871 1646 
1 5 8291 5170 1393 5381 8203 
1 12 8203 2864 3547 3660 5196 3791 208 8047 5271 7988 4122 7941 
3 4 5084 8108 4905 4200 
3 3 5084 8162 2010 
1 5 5084 8187 8206 5250 4855 
1 10 4855 3552 8323 5494 2132 8368 2407 8399 8394 8393 
1 3 8368 2292 8359 
1 2 2608 2674 
1 2 5619 8284 
1 3 2539 8281 1796 
1 2 8346 2487 
1 6 2827 8389 8375 8357 1731 2994 
1 3 8375 4208 2909 
1 2 8389 4208 
1 9 2294 5797 5242 5641 7892 3642 4972 7871 1959 
1 4 7892 3642 7849 7841 
1 4 7805 3312 7854 5242 
1 2 3312 7849 
1 2 3312 7812 
2 6 7805 7794 7774 4407 2692 1571 
1 3 4407 4652 2884 
1 4 4737 2004 7905 7935 
1 8 4737 1451 1281 7818 7804 947 7767 7744 
1 6 7818 7802 3240 3313 7746 4407 
1 3 7774 3968 7841 
1 2 7744 7700 
1 6 1571 1741 7639 5637 7588 2122 
1 3 2884 7662 7639 
1 3 7588 3902 584 
1 8 2122 7546 4799 2712 4890 2320 2790 7383 
1 3 4890 5654 631 
1 2 5468 3235 
1 2 6985 5684 
1 5 4351 4451 3441 4241 7229 
2 7 837 2347 7155 2508 7172 4128 2956 
1 3 7229 7222 4128 
2 5 2956 2015 5892 7249 7195 
1 7 7249 5892 5945 7264 5195 5667 7360 
1 6 7360 7331 7293 1145 7254 7229 
4 4 5945 3420 7222 7229 
1 6 7360 5767 5705 7369 7384 7383 
1 6 7360 5767 7337 7342 7314 2650 
2 7 7360 3417 2125 7444 5939 7506 3012 
1 2 3012 2122 
1 4 3012 7538 7553 214 
2 4 214 7545 424 7448 
1 3 7448 7432 7444 
1 2 7448 1011 
3 9 5667 4108 7364 5433 7363 2793 1214 7429 7452 
1 2 3417 4108 
1 6 7444 7442 7453 7436 3657 7383 
1 6 2125 5522 835 5705 7386 7384 
1 5 7506 7473 7436 3657 2790 
1 3 7264 3011 7249 
1 3 214 3705 7638 
1 2 7638 4084 
1 5 7190 5447 7159 5891 7151 
1 2 7190 7195 
1 6 7159 1089 1312 7252 7285 5771 
1 4 5771 1362 5326 7452 
3 4 7452 7471 552 7556 
2 6 5771 7285 7268 4090 4923 7195 
2 5 2793 5837 7312 1711 7268 
1 4 7363 7311 7244 7195 
1 4 7252 4713 3758 5824 
1 4 4713 5390 856 7151 
1 9 3758 7308 7339 1362 7402 1025 5068 552 7556 
1 6 1362 3751 7350 363 876 7341 
1 3 876 363 4868 
1 6 7452 5374 251 7472 3971 7448 
1 7 552 7533 7542 3622 7543 7544 7545 
1 3 251 5599 3622 
1 4 3971 5316 7544 214 
1 4 5374 7484 7512 7533 
1 3 5433 5420 3971 
1 5 1214 7431 251 7472 3971 
1 4 7363 5288 3798 7472 
1 3 2793 7422 251 
1 5 5326 7380 1789 5837 7312 
1 4 5771 7325 7336 7312 
1 2 7312 7311 
1 4 7379 7402 7435 5068 
1 2 7379 3751 
2 4 3622 4715 2157 5779 
1 4 4715 3480 7566 7556 
2 6 7556 1357 7632 7661 61 5240 
1 2 7716 4711 
2 5 552 2749 3061 5729 5384 
1 5 5384 4419 7541 1752 4573 
1 7 4419 7516 5729 3061 795 1602 5068 
2 6 7556 5608 7595 1088 4867 1986 
1 4 1357 7610 7647 7675 
1 4 5729 3061 2749 7556 
3 9 7195 1141 7123 461 5205 7056 7049 2181 7085 
1 4 2181 7066 2723 3317 
1 3 7085 1267 7091 
1 3 7085 7120 7151 
4 4 7049 3582 7132 7159 
1 2 3582 5205 
1 2 7132 7123 
1 2 5447 1141 
1 3 7049 1763 4959 
1 3 7049 1115 6989 
1 4 7056 1587 7033 1115 
1 3 3582 462 7120 
1 2 1763 7010 
2 6 5824 7235 3410 7234 178 7224 
1 6 5824 7253 7235 3410 1417 3850 
1 7 7308 7279 7276 4899 7292 2319 4228 
1 5 7151 7143 3870 7177 178 
1 2 4701 14960 
1 2 2587 7404 
1 2 7322 4272 
1 2 7322 7302 
1 4 7322 14959 1182 14960 
1 2 14959 1182 
1 2 7322 7327 
3 3 3847 3449 7467 
1 2 2587 3449 
1 4 14960 2587 3847 7467 
1 2 7281 4272 
1 2 7302 7270 
1 3 5300 7441 3847 
1 7 5187 7421 7397 3181 7338 7304 7280 
1 6 631 3503 7629 7666 7689 7718 
1 8 4084 1741 4997 2884 7668 584 3129 631 
1 3 5779 7700 7716 
1 4 4711 7739 3693 5240 
1 3 7586 7562 4573 
1 2 7935 2410 
1 5 7935 7913 7929 7904 3562 
2 7 4200 8120 684 1735 8005 4981 2410 
1 6 2608 5938 8217 2271 4787 8277 
1 6 8277 2539 8281 5619 3552 5494 
1 2 2827 4661 
1 5 4200 47 5098 3518 2608 
1 2 2010 3660 
1 4 8221 4142 8272 5170 
1 3 8306 8273 8291 
1 4 1713 8182 8210 1430 
1 3 5248 1543 8067 
1 3 8166 96 8199 
1 3 8141 8165 1713 
1 2 8086 3202 
1 7 8012 2640 2766 7989 2845 7994 7988 
1 3 1959 519 7941 
1 6 3562 7900 3224 7874 5931 2076 
1 3 2076 7840 2456 
1 3 2456 7780 3650 
1 5 3408 7717 3561 5848 1986 
1 2 3650 3408 
1 6 3408 4073 4366 7697 2894 7586 
1 12 947 3111 7827 7831 7817 561 3056 7793 7814 1310 5440 2456 
1 4 1959 3229 1281 7818 
1 3 150 7920 3235 
1 2 3301 7680 
1 3 7570 7572 7539 
1 3 7412 7428 2910 
1 2 7433 7412 
1 5 2910 5256 4552 7365 7340 
1 6 7421 3907 5898 7356 2077 5920 
1 4 898 7523 5407 184 
1 5 5654 2321 7519 7493 4471 
3 4 8102 8132 5026 8161 
1 2 3202 8086 
1 3 8161 3660 2010 
1 3 4737 4410 3111 
